Audio I2S:
I2SC0_MCK   PA0     C11
I2SC0_CK    PA1     D12
I2SC0_WS    PA15    L5
I2SC0_DI    PA16    K5
I2SC0_DO    PA30    A10

Baseband I2S:
I2SC1_MCK   PA19    H1
I2SC1_CK    PA20    H3
I2SC1_WS    PE0     C2
I2SC1_DI    PE2     B1
I2SC1_DO    PE1     A1

Control SPI:
SPI0_SPCK   PD22    M8
SPI0_NPCS0  PB2     J2
SPI0_MISO   PD20    K9
SPI0_MOSI   PD21    H9

N/U SPI:
SPI1_SPCK   PC24    B6
SPI1_NPCS0  PC25    C5
SPI1_MISO   PC26    F2
SPI1_MOSI   PC27    E2
